11111111111
100P00C0001
1000C110E01
11111111111