11111111111111111
100P00100000C0000
10000000011110000
111100000000000C1
11000000000000001
1C000000000111111
11111100000000001
1C00000000C110E01
11111111111111111