111111111
100000C01
10P000001
10C002001
1000000E1
111111111
