11111111111111111
100P00100000CX001
10000000011110001
111100000000000C1
11000000000000001
1C000000000111111
111111X0000000001
1C00000000C110E01
11111111111111111