111111111
100000001
10P000001
100000001
1000000E1
111111111
