11111111111111111
100P0010000000001
10000000011110001
11110000000000001
11000000000000001
10000000000111111
11111100000000001
10000000000110E01
11111111111111111